20, 10
####################
#....^%.....^...#.*#
#...#.#.##.####b#..#
#.....#..#.#..#.#..#
#...#.##.#...#####^#
#.%.A..^.##B##...%.#
#.###.####...##.#..#
#.#.#.#.a#..%...#..#
#....@..##.#.#.....#
####################

7, 5
#####*#
#..a#.#
#.%.#.#
#@..A.#
#######

20, 20
####################
#c.......C.........#
###.#.#.##.........#
#.....#..#.........#
#.#.#.##.A..%......#
#.%....^.#..b...^..#
#.###.##.#.........#
#.#.#.#.a#.........#
#...#@..###.#.#.#.##
###.#####.%........#
#...#.....#.#.#.#.##
###.#.#####........#
#.....#..##.##..#.^#
#####.##.#...#^.#..#
#......^.#.#.#..#..#
#.######.#...#.###B#
#........#.#.#.#...#
#####.####...#.#...#
#.^........#...%...#
####################
