10, 10
##########
#*.^..%..#
###.#.#.##
#.....#..#
#.#.#.##.#
#.%.A..^.#
#.###.####
#.#.#.#.a#
#....@..##
##########

4, 4
####
#..#
#@.*
####

20, 20
####################
#c.......C.........#
###.#.#.##.........#
#.....#..#.........#
#.#.#.##.A..%......#
#.%....^.#..b...^..#
#.###.##.#.........#
#.#.#.#.a#.........#
#...#@..###.#.#.#.##
###.#####.%........#
#...#.....#.#.#.#.##
###.#.#####........#
#.....#..##.##..#.^#
#####.##.#...#^.#..#
#......^.#.#.#..#..#
#.######.#...#.###B#
#........#.#.#.#...#
#####.####...#.#...#
#.^........#...%...#
####################
