20, 10
####################
#....^%.....^...#.*#
#...#.#.##.####b#..#
#.....#..#.#..#.#..#
#...#.##.#...#####^#
#.%.A..^.##B##...%.#
#.###.####...##.#..#
#.#.#.#.a#..%...#..#
#....@..##.#.#.....#
####################
