17, 10
#################
#....^%.....^...#
#...#.#.##.####b#
#.....#..#.#..#.#
#...#.##.#...##.#
#.%.A..^.##B##..#
#.###.####...####
#.#.#.#.a#..%..##
#....@..##.#.#.*#
#################
