20, 15
####################
#....^%.....^...#.c#
#...#.#.##.####b#..#
#.....#..#.#..#.#..#
#...#.##.#...#####^#
#.%.A..^.##B##...%.#
#.###.####...##.#..#
#.#.#.#.a#..%...#..#
#....@..##.#.#.....#
##################C#
#..................#
#.............%....#
#..................#
#*......^..........#
####################